access	access
accommodation	accommodation
accuracy	accuracy
administration	administration
admiration	admiration
advertising	advertising
advice	advice
aggression	aggression
agriculture	agriculture
air conditioning	air conditioning
aircraft	PLURAL aircraft
alcohol	alcohol
aluminium	aluminium
amazement	amazement
analysis	PLURAL analyses
anger	anger
annoyance	annoyance
anticipation	anticipation
anxiety	anxiety
applause	applause
appreciation	appreciation
approval	approval
archaeology	archaeology
architecture	architecture
artificial intelligence	artificial intelligence
aspirin	PLURAL aspirin or aspirins
assistance	assistance
astonishment	astonishment
astronomy	astronomy
athletics	athletics
attention	attention
availability	availability
awareness	awareness
awe	awe
backing	backing
backpacking	backpacking
bacon	bacon
badminton	badminton
baggage	baggage
banking	banking
bark	bark
basis	PLURAL bases
beauty	beauty
beef	beef
behaviour	behaviour
biology	biology
black	black
blackmail	blackmail
blame	blame
blindness	blindness
blood	blood
boxing	boxing
brass	brass
bravery	bravery
bread	bread
breath	breath
bribery	bribery
broadband	broadband
broccoli	broccoli
brother-in-law	PLURAL brothers-in-law
bus	PLURAL buses
businessman	PLURAL businessmen
businesswoman	PLURAL businesswomen
butter	butter
calf	PLURAL calves
camping	camping
capitalism	capitalism
capture	capture
carbon	carbon
carbon dioxide	carbon dioxide
carbon monoxide	carbon monoxide
cardboard	cardboard
carelessness	carelessness
cargo	cargoes
cash	cash
catering	catering
centigrade	centigrade
central heating	central heating
champagne	champagne
chaos	chaos
charisma	charisma
cheerfulness	cheerfulness
chemistry	chemistry
chess	chess
chewing gum	chewing gum
child	PLURAL children
chilli	PLURAL chillies
cholesterol	cholesterol
clarity	clarity
climate change	climate change
climbing	climbing
closeness	closeness
clothing	clothing
clumsiness	clumsiness
coaching	coaching
cod	PLURAL cod
coherence	coherence
coldness	coldness
commerce	commerce
common sense	common sense
communication	communication
competence	competence
completion	completion
complexity	complexity
concrete	concrete
confidence	confidence
congestion	congestion
consent	consent
conservation	conservation
consumption	consumption
continuity	continuity
contraception	contraception
cooking	cooking
coolness	coolness
cooperation	cooperation
copper	copper
coral	coral
corn	corn
corruption	corruption
cotton	cotton
counselling	counselling
countryside	countryside
courage	courage
courtesy	courtesy
coverage	coverage
craziness	craziness
creativity	creativity
credibility	credibility
crisis	PLURAL crises
criterion	criteria
crossroads	PLURAL crossroads
cultivation	cultivation
curriculum	PLURAL curricula or curriculums
custody	custody
customs	customs
cutlery	cutlery
cycling	cycling
damage	damage
dancing	dancing
darkness	darkness
data	data
daughter-in-law	PLURAL daughters-in-law
daycare	daycare
daylight	daylight
daytime	daytime
decay	decay
deceased	deceased
dedication	dedication
deer	PLURAL deer
denim	denim
dependence	dependence
despair	despair
desperation	desperation
destruction	destruction
determination	determination
devastation	devastation
diagnosis	diagnoses
diarrhoea	diarrhoea
dice	dice
diesel	diesel
digestion	digestion
dignity	dignity
diplomacy	diplomacy
dirt	dirt
disapproval	disapproval
disco	PLURAL discos
discontent	discontent
discretion	discretion
discrimination	discrimination
disgust	disgust
dishonesty	dishonesty
dismay	dismay
displacement	displacement
disposal	disposal
disrespect	disrespect
dissatisfaction	dissatisfaction
distress	distress
diving	diving
DNA	DNA
dominance	dominance
domination	domination
doom	doom
duration	duration
dust	dust
eagerness	eagerness
ease	ease
east	east
echo	echoes
economics	economics
effectiveness	effectiveness
efficiency	efficiency
electricity	electricity
electronics	electronics
elegance	elegance
elimination	elimination
empathy	empathy
emphasis	PLURAL emphases
employment	employment
endurance	endurance
energy	energy
engineering	engineering
enjoyment	enjoyment
enthusiasm	enthusiasm
envy	envy
equality	equality
equipment	equipment
erosion	erosion
evidence	evidence
evolution	evolution
excitement	excitement
exhaustion	exhaustion
expansion	expansion
expenditure	expenditure
extinction	extinction
eyesight	eyesight
fairness	fairness
fame	fame
farming	farming
fast food	fast food
father-in-law	PLURAL fathers-in-law
feedback	feedback
fighting	fighting
fish	PLURAL fish or fishes
fisherman	PLURAL fishermen
fishing	fishing
fitness	fitness
flesh	flesh
flexibility	flexibility
flour	flour
flu	flu
fluency	fluency
folk	folk
foot	PLURAL feet
forgiveness	forgiveness
formula	PLURAL formulas, formulae
friction	friction
friendliness	friendliness
fulfilment	fulfilment
fun	fun
funding	funding
fur	fur
furniture	furniture
gambling	gambling
gardening	gardening
garlic	garlic
gas	PLURAL gasses, gases
generosity	generosity
genetics	genetics
geography	geography
geology	geology
giraffe	PLURAL giraffes
glamour	glamour
globalization	globalization
global warming	global warming
glory	glory
glue	glue
go	PLURAL goes
gold	gold
golf	golf
good	good
grace	grace
grammar	grammar
grandchild	PLURAL grandchildren
grass	grass
greatness	greatness
greed	greed
grief	grief
guidance	guidance
guilt	guilt
gymnastics	gymnastics
hail	hail
half	PLURAL halves
ham	ham
handball	handball
handwriting	handwriting
happiness	happiness
harassment	harassment
hardware	hardware
harm	harm
hate	hate
hatred	hatred
headquarters	PLURAL headquarters
health	health
health care	health care healthcare
heat	heat
heating	heating
heaven	heaven
hell	hell
heritage	heritage
hero	PLURAL heroes
hip-hop	hip-hop
hockey	hockey
homelessness	homelessness
homework	homework
honesty	honesty
honey	honey
horror	horror
hospitality	hospitality
housewife	PLURAL housewives
housework	housework
housing	housing
humanity	humanity
humility	humility
hundred	PLURAL hundred or hundreds
hunting	hunting
hygiene	hygiene
hypocrisy	hypocrisy
hypothesis	PLURAL hypotheses
ice	ice
ice hockey	ice hockey
ice skating	ice skating
identification	identification
ignorance	ignorance
immigration	immigration
impatience	impatience
implementation	implementation
importance	importance
imprisonment	imprisonment
independence	independence
indifference	indifference
individuality	individuality
inferiority	inferiority
inflation	inflation
information	information
innocence	innocence
insecurity	insecurity
insomnia	insomnia
insurance	insurance
integration	integration
integrity	integrity
intelligence	intelligence
intensity	intensity
interference	interference
intolerance	intolerance
ironing	ironing
IT	IT
jargon	jargon
jazz	jazz
jealousy	jealousy
jewellery	jewellery
jogging	jogging
journalism	journalism
junk	junk
junk food	junk food
junk mail	junk mail
justice	justice
kilo	PLURAL kilos
kindness	kindness
knife	PLURAL knives
laughter	laughter
laundry	laundry
laziness	laziness
leadership	leadership
leaf	PLURAL leaves
learning	learning
leather	leather
legislation	legislation
leisure	leisure
lemonade	lemonade
liberty	liberty
life	PLURAL lives
lighting	lighting
lightning	lightning
likelihood	likelihood
linen	linen
literacy	literacy
literature	literature
litter	litter
loaf	PLURAL loaves
loathing	loathing
logic	logic
loneliness	loneliness
longevity	longevity
loyalty	loyalty
luck	luck
luggage	luggage
lure	lure
machinery	machinery
magic	magic
maintenance	maintenance
make-up	make-up
management	management
mango	PLURAL mangos, mangoes
mankind	mankind
manufacturing	manufacturing
marketing	marketing
materialism	materialism
meat	meat
mediocrity	mediocrity
memo	PLURAL memos
midday	midday
midnight	midnight
milk	milk
millennium	millennia
million	PLURAL million or millions
mineral water	mineral water
mining	mining
mint	mint
momentum	momentum
money	money
moonlight	moonlight
morale	morale
mortality	mortality
mosquito	PLURAL mosquitoes
mother-in-law	PLURAL mothers-in-law
mouse	PLURAL mice
mud	mud
music	music
mustard	mustard
neglect	neglect
negligence	negligence
nervousness	nervousness
networking	networking
news	news
nightlife	nightlife
noon	noon
normality	normality
north	north
northeast	northeast
northwest	northwest
nostalgia	nostalgia
nutrition	nutrition
obesity	obesity
offspring	PLURAL offspring
openness	openness
opposition	opposition
optimism	optimism
output	output
overtime	overtime
ownership	ownership
oxygen	oxygen
ozone	ozone
paperwork	paperwork
parking	parking
pasta	pasta
patience	patience
pay	pay
peace	peace
peer pressure	peer pressure
penny	PLURAL pence or p
perfection	perfection
permission	permission
perseverance	perseverance
persistence	persistence
person	PLURAL people
petrol	petrol
phenomenon	phenomena
photo	PLURAL photos
photograph	photo
photography	photography
physics	physics
piano	PLURAL pianos
planning	planning
pocket money	pocket money
poetry	poetry
politeness	politeness
politics	politics
pollution	pollution
pop	pop
popularity	popularity
pork	pork
posture	posture
potato	PLURAL potatoes
potential	potential
pottery	pottery
poverty	poverty
praise	praise
preservation	preservation
prestige	prestige
prevention	prevention
prey	prey
pride	pride
privacy	privacy
pro	PLURAL pros
productivity	productivity
programming	programming
proof	proof
propaganda	propaganda
prosperity	prosperity
protection	protection
protein	protein
proximity	proximity
psychology	psychology
publicity	publicity
public transport	public transport
punctuation	punctuation
purity	purity
pursuit	pursuit
quiet	quiet
quiz	PLURAL quizzes
racism	racism
radiation	radiation
radio	PLURAL radios
rain	rain
rap	rap
ratio	PLURAL ratios
reach	reach
readiness	readiness
reasoning	reasoning
recruitment	recruitment
recycling	recycling
regard	regard
registration	registration
relaxation	relaxation
relevance	relevance
reliability	reliability
remorse	remorse
renovation	renovation
resentment	resentment
resilience	resilience
resolve	resolve
restraint	restraint
retail	retail
retention	retention
revenge	revenge
reverse	reverse
revision	revision
rice	rice
richness	richness
rubbish	rubbish
rudeness	rudeness
rugby	rugby
running	running
sadness	sadness
safety	safety
sailing	sailing
salesman	PLURAL salesmen
salesperson	PLURAL salespeople
saleswoman	PLURAL saleswomen
salmon	PLURAL salmon
salt	salt
sand	sand
satisfaction	satisfaction
scarf	PLURAL scarves or scarfs
scenario	PLURAL scenarios
scenery	scenery
schoolchild	PLURAL schoolchildren
schooling	schooling
science fiction	science fiction
scope	scope
scrutiny	scrutiny
security	security
self	PLURAL selves
self-assurance	self-assurance
self-awareness	self-awareness
self-confidence	self-confidence
self-control	self-control
self-discipline	self-discipline
self-esteem	self-esteem
selfishness	selfishness
self-reliance	self-reliance
self-respect	self-respect
serenity	serenity
series	PLURAL series
severity	severity
sewing	sewing
sex	sex
shampoo	PLURAL shampoos
sheep	PLURAL sheep
shelf	PLURAL shelves
shopping	shopping
shyness	shyness
sickness	sickness
sightseeing	sightseeing
significance	significance
silk	silk
silver	silver
simplicity	simplicity
simplification	simplification
sincerity	sincerity
singing	singing
sister-in-law	PLURAL sisters-in-law
skateboarding	skateboarding
skating	skating
ski	PLURAL skis
skiing	skiing
sky	sky
slang	slang
slaughter	slaughter
slavery	slavery
smog	smog
smoke	smoke
smoking	smoking
snow	snow
snowboarding	snowboarding
socialism	socialism
social networking	social networking
softness	softness
software	software
solidarity	solidarity
solitude	solitude
solo	PLURAL solos
son-in-law	PLURAL sons-in-law
sorrow	sorrow
soup	soup
south	south
southeast	southeast
southwest	southwest
soya	soya
spam	spam
species	PLURAL species
spectrum	spectra
speculation	speculation
spelling	spelling
spending	spending
spinach	spinach
spokesman	PLURAL spokesmen
spokesperson	PLURAL spokespeople
sponsorship	sponsorship
squash	squash
stability	stability
stadium	PLURAL stadiums or stadia
stamina	stamina
stardom	stardom
starvation	starvation
status	status
steam	steam
steel	steel
stimulus	PLURAL stimuli
stock	stock
storage	storage
stubbornness	stubbornness
studio	PLURAL studios
stuff	stuff
stupidity	stupidity
suffering	suffering
sugar	sugar
suitability	suitability
sunlight	sunlight
sunshine	sunshine
superiority	superiority
supervision	supervision
support	support
surfing	surfing
survival	survival
suspense	suspense
sustainability	sustainability
sweat	sweat
swimming	swimming
syllabus	syllabuses, syllabi
sympathy	sympathy
table tennis	table tennis
tact	tact
teaching	teaching
teamwork	teamwork
techno	techno
tenderness	tenderness
tennis	tennis
terrorism	terrorism
thesis	PLURAL theses
thief	PLURAL thieves
thousand	PLURAL thousand or thousands
thunder	thunder
timing	timing
tiredness	tiredness
tobacco	tobacco
today	today
tolerance	tolerance
tomato	PLURAL tomatoes
tomorrow	tomorrow
ton	PLURAL tons or ton
tonight	tonight
tooth	PLURAL teeth
toothpaste	toothpaste
tornado	PLURAL tornados, tornadoes
torture	torture
toughness	toughness
tourism	tourism
traffic	traffic
training	training
tranquility	tranquility
transportation	transportation
trash	trash
travel	travel
trekking	trekking
trio	PLURAL trios
trust	trust
tuition	tuition
tuna	PLURAL tuna
uncertainty	uncertainty
underwear	underwear
unemployment	unemployment
unhappiness	unhappiness
unity	unity
unrest	unrest
unwillingness	unwillingness
upkeep	upkeep
usefulness	usefulness
validity	validity
vandalism	vandalism
vanity	vanity
vegetation	vegetation
velvet	velvet
video	PLURAL videos
vinegar	vinegar
violence	violence
virtual reality	virtual reality
vitality	vitality
volcano	PLURAL volcanoes or volcanos
volleyball	volleyball
walking	walking
warehouse	warehouses
warmth	warmth
washing-up	washing-up
water	water
wealth	wealth
weather	weather
welfare	welfare
well-being	well-being
west	west
wheat	wheat
wife	PLURAL wives
wildlife	wildlife
willingness	willingness
willpower	willpower
windsurfing	windsurfing
wisdom	wisdom
wit	wit
wolf	PLURAL wolves
woman	PLURAL women
wool	wool
worse	worse
wreckage	wreckage
writing	writing
xenophobia	xenophobia
yoga	yoga
zero	PLURAL zeros or zeroes
zoo	PLURAL zoos
